{
	"enemies": [
		[1,0,1,0,1,0,1,0,1,0,1],
		[0,1,0,1,0,1,0,1,0,1,0],
		[1,0,1,0,1,0,1,0,1,0,1],
		[0,1,0,1,0,1,0,1,0,1,0],
		[1,0,1,0,1,0,1,0,1,0,1],
		[0,1,0,1,0,1,0,1,0,1,0],
		[1,0,1,0,1,0,1,0,1,0,1]
	],

	"speed": 0.5
}
